NO ./textures/Wall_N.xpm
SO ./textures/Wall_S.xpm
EA ./textures/Wall_E.xpm
WE ./textures/Wall_W.xpm

C 0,0,42
F 0,0,12

                                                                                            
                                                                                            
                                                                                            
                                                                                            
                                                                                            
                                            1                                               
                                           111                                              
                                          11011                                             
                                         1100011                                            
                                        110000011                                           
                                 11111111000000011111111                                    
                                  1100000000N0000000011                                     
                                   1100000000000000011                                      
                                    11000000000000011                                       
                                     110000111000011                                       
                                      110011 110011                                        
                                      11011   11011                                       
                                     11011     11011                                       
                                    11011       11011                                     
                                   11111         11111                                    
                                  111               111                                    
                                                                                            
                                                                                            